7 10
xxxxxxx
x--p--x
x-btb-x
xxtbtxx
xx-b-xx
x-btb-x
x-tbt-x
x-tbt-x
x--x--x
xxxxxxx